00a00093
ffb00113
002081b3
40208233
003092b3
0032d333
403153b3
0020f433
0020e4b3
0020c533
001125b3
0020b633
00012693
fff0b713
fff0c793
0010e813
0070f893
00409913
00495993
40215a13
00001ab7
00001b17
00102023
00002b83
00101223
00401c03
00405c83
00200423
00800d03
00804d83
00000e13
01708463
001e0e13
00209463
001e0e13
00114463
001e0e13
0020d463
001e0e13
0020e463
001e0e13
00117463
001e0e13
00800eef
001e0e13
00000f17
00cf0fe7
001e0e13