00000004
00000008
00000002
00000001
00000006
