00000001
00000002
00000004
00000006
00000008
