00000293
00500313
00000513
fff30593
04b55063
00000613
00c50733
00b74463
0280006f
00261793
00f287b3
0007a803
0047a883
0108d663
0117a023
0107a223
00160613
fd5ff06f
00150513
fc5ff06f
0000006f